R  1000 800
NO images/eagle.xpm
WE images/dungeon_wall.xpm
SO images/eagle.xpm
EA images/dungeon_wall.xpm
S images/ghini.xpm
F images/mossy.xpm
C 135,206,235

           1
          1S1
11111111111 111111111111111111111111
1 2 0     1 100000 1 400   000002041
100 0 03 1101 2000 1 0100020000 00001
10 044400010  00000 00000000000000001
11111111 110 0000011100000040000000 1
100024400000 0000000011100000000000 1
1 000000  2000000000 02000000000000001
1 00000040000004   000000000000400001
1000 000000000000000 0000000000000 11
140000002000000020000000000 00000001 
1111111111110000000000110000000101111
      100000011100000001100000100001
      11111111110 01111 0 11110 001
               11111  11111 111111 
