R  1000 800
NO images/dungeon_wall.xpm
WE images/dungeon_wall.xpm
SO images/dungeon_wall.xpm
EA images/dungeon_wall.xpm
S  images/map.xpm
F 1,154,3
C 135,206,235
             1
            1 1
1111111111111 111111111111111111111111
 1220 00001 100000 1 000   000000001
100 0 0021101 2000 1 0100020000200001
10 000000010  00000 00000000000000001
11111111 110 0000011100000000000000 1
10002S000202 0020000011100000000000 1
1 002000 22200200002 02000000000000001
1 00000002200202002000000000000000001
1000 020002000020200 0000000000000 11
100000202000020000020000000 00000001 
111111100000000000000110000000101111
      100000011100000001100000100001
      111111111000 01100 0 1 010 001
               11111  11111 1111111
