R  1300 1000
NO images/eagle.xpm
WE images/dungeon_wall.xpm
SO images/eagle.xpm
EA images/dungeon_wall.xpm
S images/ghini.xpm
F images/mossy.xpm
C 135,206,235

             1
            1 1
1111111111111 111111111111111111111111
 12 0S    01 100000 1 000   000000001
100 0 00 1101 2000 1 0100020000200001
10 033400010  00000 00000000000000001
11111111 110 0000011100000000000000 1
100023400000 0000000011100000000000 1
1 000000  2000000000 02000000000000001
1 00000000000000000000000000000000001
1000 000000000000000 0000000000000 11
100000002000000000000000000 00000001 
111111100000000000000110000000101111
      100000011100000001100000100001
      111111111000 01100 0 1 010 001
               11111  11111 1111111
