R  1200 850
NO images/wall_textures/old_wall.xpm
WE images/wall_textures/old_wall.xpm
SO images/wall_textures/old_wall.xpm
EA images/wall_textures/old_wall.xpm
S images/enemies/ghini.xpm
F images/wall_textures/dungeon_wall.xpm
C 135,206,235

           1
          1S1
11111111111 11111111111111111
1 14 2   31 14    41 4   2 21
1414   111141 2    1 2  4  4 1
1   4 4 42141 4 4  1    2    1
11111111 1141     411    4   1
144 2     241    4   1111111 1
1  2   4    1  4    2 2  4    1
1  4 4  4  4   2          44 1
1 4  2 4    1     4   1      1
1  4 4  2   1  2      1      1
11111111111 1     4   11 11  1
      12222  1    42 4 1 4414 1
      111111111144444411111111
               1111111
