R 999 599
WE ../tests/cub3d/koto/cub3d/images/koto_west.xpm
NO ../tests/cub3d/koto/cub3d/images/koto_north.xpm
EA ../tests/cub3d/koto/cub3d/images/koto_east.xpm
SO ../tests/cub3d/koto/cub3d/images/koto_south.xpm
C 25,151,235
F 81,155,80
S ../tests/cub3d/koto/cub3d/images/koto_sprite.xpm



     1     
11111N1111
10 0101  1
10101 1001
101 101 01
10000 0001
1011111 01
10120 1001
1011101 01
11111   11
1100011 11
111 111 11
1   111 11
111      1
1111111111
