R 1000 1000
NO images/eagle.xpm
SO images/redbrick.xpm
WE images/greystone.xpm
EA images/mossy.xpm

S images/barrel.xpm
F 0,154,23
C 135,206,235

 111111111111111111 1111111111111111
 1S00200001010000001 0000000000000001
100202000110100000 1 0000000000200001
1020000000101000000000000000000000001
1111101111101000001110000000000000001
1000000000001000000001110000000000001
1000000000000000000 00000000000000001
1000000000000000000000000000000000001
1000200000000000000020000000000000011
100000000000000000000000000000000001
111111100000000000000110000000100001
      100000011100000001100000100001
      111111111000001100000100100001
               11111  11111 1111111
