R 1000 1000
NO images/eagle.xpm
WE images/greystone.xpm
SO images/redbrick.xpm
EA images/mossy.xpm
S images/barrel.xpm
F 1,154,3
C 135,206,235
             1
            1S1
            1 1
            1 1
1111111111111 111111111111111111111111
 1  0 000010100000 1 00000 000000001
100 0 002110122000 1 0000020000200001
10 0000000101 00000 00000000000000001
1111101111101000001110000000000000001
10000000000010000000011100000000000 1
1 000000  2000000000 00000000000000001
1 00000000000000000000000000000000001
1000 000000000000000 0000000000000 11
100000002000000000000000000 00000001
111111100000000000000110000000101111
      100000011100000001100000100001
      111111111000 011000001 010 001
               11111  11111 1111111
