R 800 800
NO images/eagle.xpm
SO images/redbrick.xpm
WE images/greystone.xpm
EA images/mossy.xpm

S images/barrel.xpm
F 0,100,0
C 173,216,230

    111111 1 111111
1111 0 000110000011111
1  0000100W    0001001 
1   100000 00000000001
11111   00000000111111
    1111111111111
