R 1000 1000
NO images/eagle.xpm
SO images/redbrick.xpm
WE images/greystone.xpm
EA images/mossy.xpm

S images/barrel.xpm
F 0,154,23
C 135,206,235
 111111111111111111 1111111111111111
 1S00200001010000001 00000 000000001
100202000110100000 1 0000000000200001
1020000000101000000 00000000000000001
1111101111101000001110000000000000001
10000000000010000000011100000000000 1
1 00000000000000000 00000000000000001
1000000000000000000000000000000000001
1000200000000000000020000000000000 11
100000000000000000000000000 00000001
111111100000000000000110000000100001
      100000011100000001100000100001
      1111111110000011000001 010 001
               11111  11111 1111111
